111111
100001
100101
101111
101101
100001
111111