111111111111111
100001010000101
100101000010001
101100011110011
100001010000001
100001000010101
101101011010101
100100001000011
100000000010001
101100111011001
100000100010001
101100001000111
101001001000101
101000010010001
111111111111111