111111111111111
100110010000101
110101000010001
101100011110011
101110010000001
100001000010101
101101011010101
100100001000011
100011000010001
101100111011001
100000101010001
101102001000111
101001001000101
101111010010001
111111111111111